11111111111
1E00000CCP1
10000000001
10000000001
10000000001
10000000001
10000000001
10000000001
11111111111